####################################################################################################
####################################################################################################
############################################################################.....................###
############################################################################.....................###
####........#............#................#......#.........................#.....................###
####........#............#................#......#.........................#.....................###
####.....................#................#......#.........................#.....................###
#########................#................#......#.........................#.....................###
####.....................#................#......#.........................#.....................###
####.......................................................................#.....................###
####..........############.############..############......................#.....................###
###########...############.############..############......................#.....................###
####..........############.############..############......................#.....................###
####..........############.############..############............................................###
####..........############.############..############............................................###
############..############.############..############............................................###
####..........############.############..############............................................###
####..........############.############..############............................................###
####..........############.############..############............................................###
####..........############.############..############............................................###
####..........############.############..############...##########...............................###
####.....................................############...##########...............................###
####.......................############..############...##########...............................###
####.......................############..############...##########...............................###
####.......................############..############...##########...............................###
####.......................############..############...##########...............................###
####.......................############..############...##########...............................###
####..........############.############..############...##########...............................###
####..........############.############..############.......######...............................###
####..........############.############..############.......######...............................###
####..........############.############..############.......######...............................###
####..........############.############..############...##########...............................###
####..........############.############..############............................................###
####..........############.############..############............................................###
####..........############.############..############............................................###
####..........############.############..........................................................###
####.......................############..........................................................###
###########................############..........................................................###
####.......................############..........................................................###
####.......................############..........................................................###
####.............................................#...............................................###
############...................#......#....#.....#.......#....#..................................###
####...........................#......#....#.....#.......#....#..................................###
####.......#.....#.............#......#....#.....#.......#....#..................................###
####.......#.....#.............#......#....#.....#.......#....#..................................###
####.......#.....#.............#......#....#.....#.......#....#..................................###
############################################################################.....................###
############################################################################.....................###
############################################################################.....................###
####################################################################################################