####################################################################################################
###############################################...................................#............#####
###############################################...................................#............#####
###############################################...................................#............#####
###############################################...................................#............#####
###############################################...................................#............#####
###############################################...................................#............#####
##################################################................................#............#####
###############################################...................................#............#####
###############################################...................................#............#####
###############################################...................................#............#####
###############################################...................................#............#####
#######......................#................#...................................#............#####
#######......................#................#...................................#............#####
#######......................#................#...................................#............#####
#######......................#................#...................................#............#####
#######......................#................#...................................#............#####
#######......................#................#...................................#............#####
#######......................#................#...................................##################
#######......................#................#...................................#............#####
#######......................#.......................................##############............#####
#######......................#....................................................#............#####
#######......................#....................................................#............#####
#######......................#....................................................#............#####
#######......................#...######...........................#.......####....#............#####
#######......................#...######...........................#.......####....#............#####
#######......................#...######........#..................#.......####....#............#####
#######......................#...######........#..................#.......####....#............#####
#######......................#...######........#..................##......####....#............#####
#######......................##########........#..................############....#............#####
#######......................#######...........#..................................#..###############
#######......................#######...........#..................................#..###############
#######......................############......#..................#...............#..###############
#######........................................#..................#...............#..###############
#######........................................#..................#...............#..###############
#######........................................#..................#...............#..###############
#######........................................#..................#.....#######........#############
#######........................................#..................#.....#..............#############
#######........................................#..................#.....#..............#############
#######........................................#..................#.....#..............#############
#######........................................#..................#.....#..............#############
#######........................................#..................#.....#..............#############
#######........................................#..................#.....#..............#############
################################################..................#.....#..............#############
################################################..................#.....#..............#############
################################################..................#.....#..............#############
################################################..................#.....#..............#############
################################################..................#.....#..............#############
################################################..................#.....#..............#############
####################################################################################################
