####################################################################################################
####################################################################################################
####################################################################################################
#####..........................................#.........#.......................................###
#####..........................................#.........#.......................................###
#####..........................................#.........#.......................................###
#####..........................................#.........#.......................................###
#####..........................................#.........#.......................................###
#####..........................................#.........#.......................................###
#####..........................................#.........#.......................................###
#####..........................................#.........#.......................................###
#####............................................................................................###
#####.............############...############..#############.....................................###
#####.............############...############..#############.....................................###
#####.............############...############..#############............#........................###
#####.............############...############..#############............#........................###
#####.............############...############..#############............#........................###
#####.............############...############..#############............#........................###
#####.............############...############..#############............#........................###
##############....############...############..#############............#........................###
#####.............############...############..#############............#........................###
#####.............############...############..#############..###########........................###
#####.............############...############..#############............#........................###
###############...############.................#############............#........................###
#####.............############.................#############............#........................###
#####.............############..........................................#........................###
###############...############..........................................#........................###
#####.............############..........................................#........................###
#####.............############..........................................#........................###
#####.............############..........................................#........................###
#####...................................................................#........................###
#####................................#######################............#.......................####
#####................................#######################............#.......................####
#####................................#######################............#......................#####
#####................................#######################............#......................#####
#####................................#######################............#.....................######
#####................................#######################...................................#####
#####................................#######################...................................#####
#####......................................................................#....................####
#####......................................................................#....................####
#####............######################################################....#.....................###
#####............######################################################....#.....................###
#####............######################################################....#.....................###
#####............###########################################################.....................###
############################################################################.....................###
############################################################################.....................###
############################################################################.....................###
############################################################################.....................###
############################################################################.....................###
####################################################################################################