####################################################################################################
####################################################################################################
#############################################################################......................#
#############################################################################......................#
####...................................#.....................#.......#......#......................#
####...................................#.....................#.......#......#......................#
####...................................#.....................#.......#......#......................#
############...........................#.....................#.......#......#......................#
####............#########..............#.....................#.......#......#......................#
####............#########..............#.....................#.......#......#......................#
####............#########............................................#......#......................#
####............#########............................................#......#......................#
####............#########............................................#......######.................#
####............#########...################.....................................#.................#
####............#########...################.....................................#.................#
####............#########...################.###########.........................#.................#
####............#########...################.###########.........................#.................#
####............#########...################.###########.........................#.................#
####............#########...################.###########.........................#.................#
####............#########...################.###########...........................................#
####............#########...################.###########...........................................#
####............#########...################.###########.........................#.................#
####............#########...################.###########.........................#.................#
####............#########...################.###########....##########...........#.................#
####............#########...################.###########....##########...........#.................#
####............#########...################.###########....##########...........#.................#
####............#########...################.###########....##########...........#.................#
####............#########...################.###########....##########...........#.................#
####............#########...################.###########....##########...........#.................#
############....#########...################.###########........######...........#.................#
####............#########...################.###########........######...........#.................#
####............#########...################.###########........######...........#.................#
####............#########...################.###########........######.............................#
####............#########...################.###########...........................................#
####............#########...################.###########...........................................#
####............#########...################.###########...........................................#
####............#########...################.......................................................#
####............#########...################.....................................#.................#
####............#########...################.....................................#.................#
####............#########...################.....................................#.................#
#############...#########...................................#....................#.................#
####..............................................#.........#......#...###.......#.................#
####...............................#.......#......#.........#......#.....#.......#.................#
####...............................#.......#......#.........#......#.....#.......#.................#
####...............................#.......#......#.........#......#.....#.......#.................#
####...............................#.......#......#.........#......#.....#.......#.................#
##############################################################################################.....#
#############################################################################......................#
#############################################################################......................#
####################################################################################################
