####################################################################################################
####################################################################################################
####################################################################################################
####################################################################################################
####################################################################################################
####............................................................................................####
####............................................................................................####
####............................................................................................####
####............................................................................................####
####..........................................###.##.###########................................####
####..........................................#.................................................####
####..........................................#.................................................####
####............................................................................#...............####
####............................................................................#...............####
################################...#######......................................#..................#
####...........................#................................................#..................#
####...........................#................................................#..................#
####............................................................................#..................#
####............................................................................#...............####
####............................................................................#...............####
####............................................................................#...............####
###########################..................................###########........#...............####
####............................#######........#####.........#.........#........................####
####............................#######........#####.........#.........#........................####
####............................#######........#####.........#.........#...........................#
####............................#######........#####.........#.........#...........................#
####............................#######........#####.........#.........#...........................#
####............................#######........#####.........#.........#...........................#
####............................#######........#####.........#.........#........................####
####............................#######........#####.........#.........#..........##################
####............................#######........#####...................#........................####
####............................#######........#####...................#........................####
####............................#######........#####.........#.........#........................####
####............................#######........#####.........#.........#........................####
####............................#######........#####.........##############.....................####
####...........................................#####......................#.....................####
####......................................................................#.....................####
####............................................................................................####
####............................................................................................####
####............................................................................................####
####.......####################################........################.........................####
####..........................#.................................................................####
####..........................#.................................................................####
####.................#........#.................................................................####
####.................#........#.................................................................####
####.................#........#.................................................................####
####.................#........#.................................................................####
####################################################################################################
####################################################################################################
####################################################################################################
